autocd         	off
cdable_vars    	off
cdspell        	off
checkhash      	off
checkjobs      	off
checkwinsize   	on
cmdhist        	on
compat31       	off
compat32       	off
compat40       	off
compat41       	off
dirspell       	off
dotglob        	off
execfail       	off
expand_aliases 	on
extdebug       	off
extglob        	off
extquote       	on
failglob       	off
force_fignore  	on
globstar       	off
gnu_errfmt     	off
histappend     	off
histreedit     	off
histverify     	off
hostcomplete   	on
huponexit      	off
interactive_comments	on
lastpipe       	off
lithist        	off
login_shell    	off
mailwarn       	off
no_empty_cmd_completion	off
nocaseglob     	off
nocasematch    	off
nullglob       	off
progcomp       	on
promptvars     	on
restricted_shell	off
shift_verbose  	off
sourcepath     	on
xpg_echo       	off
